XXXXXXXXXXXXXXXXXXXXXXXXXXX
XWWWWWWWWWWWWWWWWWWWWWWWWWX
XWFFFFFFFSFFFWFFFFFFFFFFFWX
XWFWFWWFWWWWFWFWWWWFWWWWFWX
XWFWFWWFWWWWFWFWWWWFWWWWFWX
XWFFFFFSFFFFFFFFFFFFFFFFFWX
XWFWWWWFWFWWWWWWWFWFWWWWFWX
XWFFFFFFWFFFFWFFFFWFFFFFFWX
XWWWWWWFWWWWFWFWWWWFWWWWWWX
XWXXXXWFWFFFFFFFFFWFWXXXXWX
XWXXXXWFWFWWWXWWWFWFWXXXXWX
XWWWWWWFWFW0XXX2WFWFWWWWWWX
DDFSFFFFFFWXXXXXWFFFFFFFFDD
XWWWWWWFWFWXX1XXWFWFWWWWWWX
XWXXXXWFWFWWWWWWWFWFWXXXXWX
XWXXXXWFWFFFFPFFFFWFWXXXXWX
XWWWWWWFWWWWFWFWWWWFWWWWWWX
XWFFFFFFWFFFFWFFFFWFFFFFFWX
XWFWWWWFWFWWWWWWWFWFWWWWFWX
XWFFFSFFFFFFFFFFFFFFFFSFFWX
XWFWWWWFWWWWFWFWWWWFWWWWFWX
XWFWWWWFWWWWFWFWWWWFWWWWFWX
XWFFFFFFFFFFFWFFFFFFFFFFFWX
XWWWWWWWWWWWWWWWWWWWWWWWWWX
XXXXXXXXXXXXXXXXXXXXXXXXXXX