W W B W B W B W W
W L1 E T3T E T3T E L2 W
B E E E E E E E B
W T2T E T2T E T3T E T4T W
B E E E E E E E B
W T2T E T1T E T4T E T4T W
B E E E E E E E B
W L4 E T1T E T1T E L3 W
W W B W B W B W W